9 12
############
#    ##G##D#
# ## ## ## #
# ## ## ## #
#     A    #
# ## # ## ##
# ## # ## ##
#    #D##G##
############