6N9
59
###########
#         #
#     @A  #
#   @  @  #
#         #
#    @    #
#         #
###########
